BACK	B AE K
BACKWARD	B AE K W ER D
CANCEL	K AE N S AH L
COME	K AH M
DOWN	D AW N
FASTER	F AE S T ER
FOLLOW	F AA L OW
FOLLOWER	F AA L OW ER
FORWARD	F AO R W ER D
GO	G OW
HALT	HH AO L T
LEFT	L EH F T
ME	M IY
MOVE	M UW V
NOW	N AW
QUARTER	K W AO R T ER
RIGHT	R AY T
ROTATE	R OW T EY T
RUN	R AH N
SLOWER	S L OW ER
SPEED	S P IY D
STAY	S T EY
STOP	S T AA P
STRAIGHT	S T R EY T
TURN	T ER N
UP	AH P
WITH	W IH DH
WITH(2)	W IH TH
